Rk,Player,Pos,Age,Tm,G,GS,MP,FG,FGA,FG%,3P,3PA,3P%,2P,2PA,2P%,eFG%,FT,FTA,FT%,ORB,DRB,TRB,AST,STL,BLK,TOV,PF,PTS▼
1,LeBron James\jamesle01,PF,33,CLE,82,82,3026,857,1580,.542,149,406,.367,708,1174,.603,.590,388,531,.731,97,612,709,747,116,71,347,136,2251
2,James Harden\hardeja01,SG,28,HOU,72,72,2551,651,1449,.449,265,722,.367,386,727,.531,.541,624,727,.858,41,348,389,630,126,50,315,169,2191
3,Anthony Davis\davisan02,PF,24,NOP,75,75,2727,780,1462,.534,55,162,.340,725,1300,.558,.552,495,598,.828,187,645,832,174,115,193,162,159,2110
4,Russell Westbrook\westbru01,PG,29,OKC,80,80,2914,757,1687,.449,97,326,.298,660,1361,.485,.477,417,566,.737,152,652,804,820,147,20,381,200,2028
5,Giannis Antetokounmpo\antetgi01,PF,23,MIL,75,75,2756,742,1402,.529,43,140,.307,699,1262,.554,.545,487,641,.760,156,597,753,361,109,106,223,231,2014
6,Damian Lillard\lillada01,PG,27,POR,73,73,2670,621,1415,.439,227,629,.361,394,786,.501,.519,493,538,.916,62,263,325,481,77,27,206,117,1962
7,Bradley Beal\bealbr01,SG,24,WAS,82,82,2977,683,1484,.460,199,530,.375,484,954,.507,.527,292,369,.791,61,302,363,373,96,36,214,160,1857
8,DeMar DeRozan\derozde01,SG,28,TOR,80,80,2711,645,1413,.456,89,287,.310,556,1126,.494,.488,461,559,.825,59,256,315,417,85,22,175,151,1840
9,Kevin Durant\duranke01,SF,29,GSW,68,68,2325,630,1222,.516,173,413,.419,457,809,.565,.586,359,404,.889,31,433,464,366,50,119,207,133,1792
10,Lou Williams\willilo02,SG,31,LAC,79,19,2589,582,1337,.435,186,518,.359,396,819,.484,.505,432,491,.880,40,158,198,417,85,19,234,106,1782
11,Kemba Walker\walkeke02,PG,27,CHO,80,80,2736,588,1363,.431,231,601,.384,357,762,.469,.516,363,420,.864,32,216,248,444,91,24,179,98,1770
12,Karl-Anthony Towns\townska01,C,22,MIN,82,82,2918,639,1172,.545,120,285,.421,519,887,.585,.596,345,402,.858,238,774,1012,199,64,115,159,285,1743
13,LaMarcus Aldridge\aldrila01,C,32,SAS,75,75,2509,687,1347,.510,27,92,.293,660,1255,.526,.520,334,399,.837,246,389,635,152,43,90,111,161,1735
14,Victor Oladipo\oladivi01,SG,25,IND,75,75,2552,640,1342,.477,161,434,.371,479,908,.528,.537,294,368,.799,47,343,390,323,177,57,219,175,1735
15,Paul George\georgpa01,SF,27,OKC,79,79,2891,576,1340,.430,244,609,.401,332,731,.454,.521,338,411,.822,72,375,447,263,161,39,212,233,1734
16,CJ McCollum\mccolcj01,SG,26,POR,81,81,2923,667,1505,.443,189,476,.397,478,1029,.465,.506,209,250,.836,53,268,321,272,77,35,151,168,1732
17,Khris Middleton\middlkh01,SF,26,MIL,82,82,2982,593,1272,.466,146,407,.359,447,865,.517,.524,320,362,.884,45,384,429,328,119,21,191,270,1652
18,Donovan Mitchell\mitchdo01,SG,21,UTA,79,71,2638,595,1362,.437,187,550,.340,408,812,.502,.506,239,297,.805,52,244,296,291,118,27,215,213,1616
19,Jrue Holiday\holidjr01,SG,27,NOP,81,81,2927,615,1244,.494,120,356,.337,495,888,.557,.543,187,238,.786,62,303,365,486,123,64,213,201,1537
20,Tobias Harris\harrito02,PF,25,TOT,80,80,2668,562,1221,.460,183,445,.411,379,776,.488,.535,179,216,.829,58,379,437,192,71,35,105,164,1486
21,Kyrie Irving\irvinky01,PG,25,BOS,60,60,1931,534,1087,.491,166,407,.408,368,680,.541,.568,232,261,.889,33,194,227,306,65,17,140,122,1466
22,Klay Thompson\thompkl01,SG,27,GSW,73,73,2506,575,1179,.488,229,521,.440,346,658,.526,.585,82,98,.837,31,246,277,185,55,34,128,117,1461
23,Harrison Barnes\barneha02,PF,25,DAL,77,77,2634,537,1208,.445,119,333,.357,418,875,.478,.494,259,313,.827,77,391,468,152,49,14,118,94,1452
24,Andrew Wiggins\wiggian01,SF,22,MIN,82,82,2979,569,1300,.438,112,338,.331,457,962,.475,.481,202,314,.643,82,276,358,160,91,51,138,163,1452
25,Joel Embiid\embiijo01,C,23,PHI,63,63,1912,510,1056,.483,66,214,.308,444,842,.527,.514,359,467,.769,143,547,690,199,40,111,234,209,1445
26,Nikola Jokić\jokicni01,C,22,DEN,75,73,2443,504,1010,.499,111,280,.396,393,730,.538,.554,266,313,.850,195,608,803,458,90,61,210,212,1385
27,Jamal Murray\murraja01,PG,20,DEN,81,80,2565,479,1062,.451,165,436,.378,314,626,.502,.529,229,253,.905,82,215,297,274,79,28,172,173,1352
28,Dwight Howard\howardw01,C,32,CHO,81,81,2463,506,911,.555,1,7,.143,505,904,.559,.556,334,582,.574,255,757,1012,105,48,131,208,249,1347
29,Devin Booker\bookede01,SG,21,PHO,54,54,1865,455,1054,.432,147,384,.383,308,670,.460,.501,289,329,.878,26,218,244,253,47,14,194,168,1346
30,Stephen Curry\curryst01,PG,29,GSW,51,51,1631,428,864,.495,212,501,.423,216,363,.595,.618,278,302,.921,36,225,261,310,80,8,153,114,1346
31,Julius Randle\randlju01,C,23,LAL,82,49,2190,504,904,.558,10,45,.222,494,859,.575,.563,305,425,.718,181,473,654,210,43,45,213,274,1323
32,Eric Bledsoe\bledser01,PG,28,TOT,74,74,2322,468,989,.473,125,360,.347,343,629,.545,.536,252,317,.795,51,233,284,370,149,42,216,185,1313
33,Jimmy Butler\butleji01,SG,28,MIN,59,59,2164,437,921,.474,70,200,.350,367,721,.509,.512,363,425,.854,79,235,314,288,116,24,108,78,1307
34,Dennis Schröder\schrode01,PG,24,ATL,67,67,2078,500,1146,.436,76,262,.290,424,884,.480,.469,225,265,.849,44,164,208,417,72,6,183,147,1301
35,Goran Dragić\dragigo01,PG,31,MIA,75,75,2378,484,1075,.450,111,300,.370,373,775,.481,.502,217,271,.801,54,253,307,359,63,12,166,180,1296
36,Ben Simmons\simmobe01,PG,21,PHI,81,81,2732,544,998,.545,0,11,.000,544,987,.551,.545,191,341,.560,145,514,659,661,140,70,278,211,1279
37,T.J. Warren\warretj01,SF,24,PHO,65,65,2142,529,1063,.498,20,90,.222,509,973,.523,.507,193,255,.757,125,208,333,85,65,41,85,149,1271
38,Will Barton\bartowi01,SG,27,DEN,81,40,2683,465,1028,.452,156,422,.370,309,606,.510,.528,182,226,.805,70,339,409,331,82,52,149,168,1268
39,Kyle Lowry\lowryky01,PG,31,TOR,78,78,2510,403,944,.427,238,596,.399,165,348,.474,.553,223,261,.854,66,368,434,537,85,19,183,192,1267
40,Carmelo Anthony\anthoca01,PF,33,OKC,78,78,2501,472,1168,.404,169,474,.357,303,694,.437,.476,148,193,.767,67,386,453,103,47,49,99,197,1261
41,Marc Gasol\gasolma01,C,33,MEM,73,73,2408,434,1033,.420,109,320,.341,325,713,.456,.473,281,337,.834,78,514,592,305,54,101,194,185,1258
42,Eric Gordon\gordoer01,SG,29,HOU,69,30,2154,415,970,.428,218,608,.359,197,362,.544,.540,195,241,.809,25,145,170,154,44,27,130,116,1243
43,Blake Griffin\griffbl01,PF,28,TOT,58,58,1970,436,996,.438,111,322,.345,325,674,.482,.493,259,330,.785,73,355,428,334,41,18,165,139,1242
44,Kyle Kuzma\kuzmaky01,PF,22,LAL,77,37,2401,468,1039,.450,159,434,.366,309,605,.511,.527,147,208,.707,88,395,483,141,49,34,140,160,1242
45,DeMarcus Cousins\couside01,C,27,NOP,48,48,1737,406,864,.470,104,294,.354,302,570,.530,.530,294,394,.746,105,512,617,257,79,76,242,183,1210
46,J.J. Redick\redicjj01,SG,33,PHI,70,70,2116,404,879,.460,193,460,.420,211,419,.504,.569,197,218,.904,9,169,178,210,35,6,103,123,1198
47,Andre Drummond\drumman01,C,24,DET,78,78,2625,466,881,.529,0,11,.000,466,870,.536,.529,239,395,.605,399,848,1247,237,114,127,200,250,1171
48,Gary Harris\harriga01,SG,23,DEN,67,65,2304,440,908,.485,156,394,.396,284,514,.553,.570,134,162,.827,37,139,176,194,122,15,119,119,1170
49,Taurean Waller-Prince\princta02,SF,23,ATL,82,82,2464,415,975,.426,176,457,.385,239,518,.461,.516,152,180,.844,50,339,389,214,85,42,191,168,1158
50,Bojan Bogdanović\bogdabo02,SF,28,IND,80,80,2464,404,852,.474,155,386,.402,249,466,.534,.565,178,205,.868,30,240,270,119,55,8,106,129,1141
51,Dario Šarić\saricda01,PF,23,PHI,78,73,2310,403,890,.453,157,399,.393,246,491,.501,.541,178,207,.860,154,366,520,202,51,20,148,160,1141
52,Otto Porter\porteot01,SF,24,WAS,77,77,2432,445,885,.503,138,313,.441,307,572,.537,.581,106,128,.828,103,389,492,157,116,41,75,151,1134
53,Jusuf Nurkić\nurkiju01,C,23,POR,79,79,2088,480,951,.505,0,7,.000,480,944,.508,.505,172,273,.630,189,519,708,143,64,111,183,247,1132
54,Jordan Clarkson\clarkjo01,SG,25,TOT,81,2,1888,430,954,.451,112,318,.352,318,636,.500,.509,152,190,.800,57,160,217,221,58,6,127,107,1124
55,Jayson Tatum\tatumja01,SF,19,BOS,80,80,2438,397,835,.475,105,242,.434,292,593,.492,.538,213,258,.826,50,352,402,128,83,58,114,170,1112
56,Kristaps Porziņģis\porzikr01,PF,22,NYK,48,48,1553,390,889,.439,90,228,.395,300,661,.454,.489,218,275,.793,62,254,316,57,36,115,93,141,1088
57,Chris Paul\paulch01,PG,32,HOU,58,58,1847,367,798,.460,144,379,.380,223,419,.532,.550,203,221,.919,37,276,313,457,96,14,128,141,1081
58,Buddy Hield\hieldbu01,SG,25,SAC,80,12,2024,416,933,.446,176,408,.431,240,525,.457,.540,71,81,.877,55,252,307,155,85,22,124,148,1079
59,Steven Adams\adamsst01,C,24,OKC,76,76,2487,448,712,.629,0,2,.000,448,710,.631,.629,160,286,.559,384,301,685,88,92,78,128,215,1056
60,Dennis Smith\smithde03,PG,20,DAL,69,69,2049,404,1024,.395,106,339,.313,298,685,.435,.446,134,193,.694,50,210,260,358,71,18,194,152,1048
61,Josh Richardson\richajo01,SF,24,MIA,81,81,2689,399,885,.451,127,336,.378,272,549,.495,.523,120,142,.845,69,216,285,231,121,75,140,199,1045
62,Kevin Love\loveke01,C,29,CLE,59,59,1651,334,729,.458,137,330,.415,197,399,.494,.552,234,266,.880,101,445,546,103,43,24,90,120,1039
63,Jeremy Lamb\lambje01,SG,25,CHO,80,18,1967,380,832,.457,94,254,.370,286,578,.495,.513,179,208,.861,49,275,324,186,61,32,93,138,1033
64,Lauri Markkanen\markkla01,PF,20,CHI,68,68,2020,374,862,.434,145,401,.362,229,461,.497,.518,140,166,.843,79,429,508,79,39,40,83,103,1033
65,Clint Capela\capelca01,C,23,HOU,74,74,2034,441,676,.652,0,1,.000,441,675,.653,.652,144,257,.560,241,561,802,68,58,137,103,185,1026
66,Aaron Gordon\gordoaa01,PF,22,ORL,58,57,1909,375,865,.434,115,342,.336,260,523,.497,.500,157,225,.698,87,370,457,136,59,45,107,111,1022
67,E'Twaun Moore\mooreet01,SG,28,NOP,82,80,2586,423,832,.508,128,301,.425,295,531,.556,.585,48,68,.706,57,181,238,187,79,12,102,182,1022
68,Jaylen Brown\brownja02,SG,21,BOS,70,70,2152,373,803,.465,121,306,.395,252,497,.507,.540,150,233,.644,66,280,346,114,70,26,124,181,1017
69,Evan Fournier\fournev01,SF,25,ORL,57,57,1837,368,802,.459,127,335,.379,241,467,.516,.538,150,173,.867,23,157,180,165,47,16,95,138,1013
70,Josh Jackson\jacksjo02,SF,20,PHO,77,35,1959,389,932,.417,57,217,.263,332,715,.464,.448,177,279,.634,95,256,351,119,80,35,146,218,1012
71,Tyreke Evans\evansty01,PG,28,MEM,52,32,1607,366,809,.452,114,286,.399,252,523,.482,.523,164,209,.785,44,221,265,269,57,17,117,96,1010
72,Robert Covington\covinro01,SF,27,PHI,80,80,2532,345,836,.413,203,550,.369,142,286,.497,.534,116,136,.853,55,378,433,156,137,72,126,238,1009
73,Ricky Rubio\rubiori01,PG,27,UTA,77,77,2254,346,827,.418,96,273,.352,250,554,.451,.476,220,254,.866,44,307,351,410,121,11,207,206,1008
74,Spencer Dinwiddie\dinwisp01,PG,24,BRK,80,58,2306,324,838,.387,141,433,.326,183,405,.452,.471,218,268,.813,40,219,259,524,68,23,128,186,1007
75,Enes Kanter\kanteen01,C,25,NYK,71,71,1830,422,713,.592,0,2,.000,422,711,.594,.592,156,184,.848,273,507,780,105,36,37,122,187,1000
76,Taj Gibson\gibsota01,PF,32,MIN,82,82,2726,425,737,.577,7,35,.200,418,702,.595,.581,142,185,.768,194,390,584,99,62,59,89,218,999
77,Tim Hardaway\hardati02,SG,25,NYK,57,54,1885,360,856,.421,130,410,.317,230,446,.516,.496,146,179,.816,32,192,224,155,62,10,92,123,996
78,Jeff Teague\teaguje01,PG,29,MIN,70,70,2311,354,794,.446,84,228,.368,270,566,.477,.499,202,239,.845,24,185,209,492,102,23,177,171,994
79,Kentavious Caldwell-Pope\caldwke01,SG,24,LAL,74,74,2458,340,798,.426,159,415,.383,181,383,.473,.526,153,194,.789,60,327,387,162,106,16,97,145,992
80,Allen Crabbe\crabbal01,SG,25,BRK,75,68,2197,337,827,.407,201,532,.378,136,295,.461,.529,115,135,.852,28,296,324,117,47,35,78,168,990
81,DeMarre Carroll\carrode01,PF,31,BRK,73,73,2180,325,785,.414,145,391,.371,180,394,.457,.506,188,246,.764,105,374,479,147,59,30,103,165,983
82,Jonas Valančiūnas\valanjo01,C,25,TOR,77,77,1727,390,687,.568,30,74,.405,360,613,.587,.590,170,211,.806,183,477,660,81,29,69,115,192,980
83,Michael Beasley\beaslmi01,PF,29,NYK,74,30,1653,409,807,.507,34,86,.395,375,721,.520,.528,124,159,.780,97,317,414,123,36,43,143,145,976
84,Marco Belinelli\belinma01,SG,31,TOT,80,2,1947,337,764,.441,149,395,.377,188,369,.509,.539,148,163,.908,20,131,151,148,66,12,94,91,971
85,Bobby Portis\portibo01,PF,22,CHI,73,4,1643,382,811,.471,80,223,.359,302,588,.514,.520,120,156,.769,159,339,498,123,50,23,103,130,964
86,Jonathon Simmons\simmojo02,SG,28,ORL,69,50,2029,354,761,.465,69,204,.338,285,557,.512,.511,185,241,.768,61,178,239,171,58,16,146,175,962
87,Brook Lopez\lopezbr01,C,29,LAL,74,72,1735,369,793,.465,112,325,.345,257,468,.549,.536,111,158,.703,74,220,294,126,30,98,98,195,961
88,Serge Ibaka\ibakase01,PF,28,TOR,76,76,2093,379,784,.483,107,297,.360,272,487,.559,.552,94,118,.797,78,400,478,62,29,99,90,209,959
89,Thaddeus Young\youngth01,PF,29,IND,81,81,2607,421,864,.487,58,181,.320,363,683,.531,.521,55,92,.598,184,328,512,152,135,36,105,175,955
90,Kelly Oubre\oubreke01,SF,22,WAS,81,11,2231,318,790,.403,126,369,.341,192,421,.456,.482,191,233,.820,59,304,363,98,80,35,90,234,953
91,Brandon Ingram\ingrabr01,SF,20,LAL,59,59,1975,358,761,.470,41,105,.390,317,656,.483,.497,192,282,.681,57,257,314,230,45,43,149,163,949
92,Rondae Hollis-Jefferson\holliro01,SF,23,BRK,68,59,1920,342,724,.472,13,54,.241,329,670,.491,.481,249,316,.788,101,358,459,167,65,48,121,145,946
93,Derrick Favors\favorde01,C,26,UTA,77,77,2153,395,702,.563,14,63,.222,381,639,.596,.573,140,215,.651,198,354,552,102,54,82,88,164,944
94,Joe Ingles\inglejo01,SF,30,UTA,82,81,2578,335,718,.467,204,464,.440,131,254,.516,.609,66,83,.795,24,320,344,392,90,20,159,178,940
95,Nikola Vučević\vucevni01,C,27,ORL,57,57,1683,399,840,.475,64,204,.314,335,636,.527,.513,77,94,.819,101,422,523,191,56,62,109,144,939
96,Willie Cauley-Stein\caulewi01,C,24,SAC,73,58,2044,388,773,.502,3,12,.250,385,761,.506,.504,153,247,.619,131,379,510,172,77,67,109,185,932
97,Al Horford\horfoal01,C,31,BOS,72,72,2277,368,753,.489,97,226,.429,271,527,.514,.553,94,120,.783,103,427,530,339,43,78,132,138,927
98,DeAndre Jordan\jordade01,C,29,LAC,77,77,2424,373,578,.645,0,0,,373,578,.645,.645,181,312,.580,329,842,1171,117,39,71,137,203,927
99,Dirk Nowitzki\nowitdi01,C,39,DAL,77,77,1900,346,758,.456,138,337,.409,208,421,.494,.547,97,108,.898,22,416,438,120,43,45,51,146,927
100,Austin Rivers\riverau01,SG,25,LAC,61,59,2057,341,805,.424,136,360,.378,205,445,.461,.508,102,159,.642,27,118,145,242,74,16,109,152,920
101,Bogdan Bogdanović\bogdabo01,SG,25,SAC,78,53,2175,344,772,.446,129,329,.392,215,443,.485,.529,100,119,.840,31,192,223,258,72,16,125,172,917
102,Courtney Lee\leeco01,SG,32,NYK,76,69,2310,343,755,.454,113,278,.406,230,477,.482,.529,114,124,.919,30,194,224,180,80,17,84,109,913
103,Terry Rozier\roziete01,PG,23,BOS,80,16,2068,316,800,.395,153,402,.381,163,398,.410,.491,115,149,.772,63,313,376,232,80,19,80,123,900
104,Dillon Brooks\brookdi01,SF,22,MEM,82,74,2350,340,772,.440,94,264,.356,246,508,.484,.501,124,166,.747,49,208,257,135,73,17,124,233,898
105,Ish Smith\smithis01,PG,29,DET,82,35,2043,389,801,.486,35,101,.347,354,700,.506,.507,81,116,.698,27,197,224,360,64,20,108,140,894
106,Rodney Hood\hoodro01,SG,25,TOT,60,23,1616,322,751,.429,127,333,.381,195,418,.467,.513,111,129,.860,22,143,165,95,45,12,70,105,882
107,Justin Holiday\holidju01,SG,28,CHI,72,72,2265,290,782,.371,161,449,.359,129,333,.387,.474,135,164,.823,31,260,291,153,80,31,93,134,876
108,Frank Kaminsky\kaminfr01,PF,24,CHO,79,4,1835,307,716,.429,104,274,.380,203,442,.459,.501,155,194,.799,46,242,288,129,36,19,66,95,873
109,Kelly Olynyk\olynyke01,PF,26,MIA,76,22,1779,316,636,.497,106,280,.379,210,356,.590,.580,134,174,.770,89,342,431,207,62,35,147,222,872
110,Wayne Ellington\ellinwa01,SG,30,MIA,77,2,2041,285,700,.407,227,579,.392,58,121,.479,.569,67,78,.859,23,195,218,79,53,8,52,94,864
111,Domantas Sabonis\sabondo01,C,21,IND,74,19,1810,340,661,.514,13,37,.351,327,624,.524,.524,168,224,.750,165,407,572,151,40,32,137,220,861
112,Nikola Mirotić\mirotni01,PF,26,TOT,55,14,1494,306,684,.447,135,358,.377,171,326,.525,.546,112,137,.818,59,346,405,80,44,39,62,108,859
113,Caris LeVert\leverca01,SF,23,BRK,71,10,1864,320,735,.435,85,245,.347,235,490,.480,.493,133,187,.711,53,207,260,299,82,22,153,159,858
114,Zach Randolph\randoza01,PF,36,SAC,59,57,1508,361,763,.473,51,147,.347,310,616,.503,.507,84,107,.785,97,300,397,127,42,10,116,119,857
115,Darren Collison\collida01,PG,30,IND,69,64,2018,316,638,.495,96,205,.468,220,433,.508,.571,127,144,.882,37,141,178,368,92,15,86,122,855
116,Jeff Green\greenje02,PF,31,CLE,78,13,1828,295,618,.477,53,170,.312,242,448,.540,.520,203,234,.868,60,186,246,99,41,34,75,149,846
117,Joe Harris\harrijo01,SG,26,BRK,78,14,1975,305,621,.491,150,358,.419,155,263,.589,.612,86,104,.827,51,209,260,128,35,20,91,153,846
118,De'Aaron Fox\foxde01,PG,20,SAC,73,60,2026,328,797,.412,47,153,.307,281,644,.436,.441,141,195,.723,33,171,204,320,70,20,173,163,844
119,Tyler Johnson\johnsty01,PG,25,MIA,72,39,2052,309,711,.435,119,324,.367,190,387,.491,.518,106,129,.822,34,214,248,165,60,34,81,148,843
120,Markieff Morris\morrima02,PF,28,WAS,73,73,1968,330,687,.480,76,207,.367,254,480,.529,.536,105,128,.820,75,334,409,142,56,38,127,216,841
121,Yogi Ferrell\ferreyo01,SG,24,DAL,82,21,2282,311,730,.426,134,359,.373,177,371,.477,.518,82,103,.796,26,223,249,201,64,9,78,153,838
122,Kent Bazemore\bazemke01,SG,28,ATL,65,65,1789,284,676,.420,108,274,.394,176,402,.438,.500,160,201,.796,25,223,248,228,100,45,157,147,836
123,Montrezl Harrell\harremo01,C,24,LAC,76,3,1293,348,548,.635,1,7,.143,347,541,.641,.636,139,222,.626,103,203,306,74,36,52,68,143,836
124,Myles Turner\turnemy01,C,21,IND,65,62,1836,306,639,.479,56,157,.357,250,482,.519,.523,160,206,.777,93,324,417,87,38,118,96,186,828
125,Jamal Crawford\crawfja01,SG,37,MIN,80,0,1653,308,742,.415,104,314,.331,204,428,.477,.485,102,113,.903,21,78,99,185,40,9,95,85,822
126,Patty Mills\millspa02,PG,29,SAS,82,36,2107,280,682,.411,154,414,.372,126,268,.470,.523,105,118,.890,26,128,154,229,55,11,106,128,819
127,Wesley Matthews\matthwe02,SF,31,DAL,63,62,2131,283,697,.406,153,402,.381,130,295,.441,.516,83,101,.822,28,170,198,172,76,16,83,140,802
128,J.J. Barea\bareajo01,PG,33,DAL,69,10,1603,303,690,.439,115,313,.367,188,377,.499,.522,80,102,.784,15,186,201,434,35,3,143,83,801
129,Elfrid Payton\paytoel01,PG,23,TOT,63,63,1808,329,667,.493,30,92,.326,299,575,.520,.516,109,168,.649,64,210,274,393,83,22,168,147,797
130,John Wall\walljo01,PG,27,WAS,41,41,1410,280,667,.420,62,167,.371,218,500,.436,.466,175,241,.726,22,128,150,393,57,45,158,80,797
131,James Johnson\johnsja01,PF,30,MIA,73,41,1943,309,614,.503,57,185,.308,252,429,.587,.550,113,162,.698,61,297,358,280,70,51,141,192,788
132,Denzel Valentine\valende01,SG,24,CHI,77,37,2095,301,721,.417,143,370,.386,158,351,.450,.517,38,51,.745,48,345,393,244,65,11,99,185,783
133,Trevor Ariza\arizatr01,SF,32,HOU,67,67,2269,268,651,.412,170,462,.368,98,189,.519,.542,76,89,.854,33,261,294,105,98,13,52,132,782
134,John Collins\collijo01,PF,20,ATL,74,26,1785,314,545,.576,16,47,.340,298,498,.598,.591,133,186,.715,176,365,541,98,47,80,105,215,777
135,Pau Gasol\gasolpa01,C,37,SAS,77,63,1812,287,627,.458,43,120,.358,244,507,.481,.492,158,209,.756,129,490,619,238,24,79,108,121,775
136,Jae Crowder\crowdja01,SF,27,TOT,80,47,2090,271,671,.404,110,341,.323,161,330,.488,.486,121,148,.818,59,216,275,99,64,21,74,187,773
137,Draymond Green\greendr01,PF,27,GSW,70,70,2287,281,619,.454,77,256,.301,204,363,.562,.516,134,173,.775,75,460,535,508,95,91,202,185,773
138,D.J. Augustin\augusdj01,PG,30,ORL,75,36,1760,244,540,.452,114,272,.419,130,268,.485,.557,164,189,.868,30,130,160,287,54,0,123,94,766
139,Dwyane Wade\wadedw01,SG,36,TOT,67,3,1536,299,682,.438,32,111,.288,267,571,.468,.462,135,189,.714,50,202,252,228,61,47,140,124,765
140,Lance Stephenson\stephla01,SG,27,IND,82,7,1850,303,709,.427,67,232,.289,236,477,.495,.475,84,127,.661,62,362,424,235,46,17,131,177,757
141,Rudy Gobert\goberru01,C,25,UTA,56,56,1816,276,444,.622,0,0,,276,444,.622,.622,204,299,.682,165,436,601,80,44,129,107,153,756
142,Robin Lopez\lopezro01,C,29,CHI,64,64,1690,342,645,.530,4,14,.286,338,631,.536,.533,68,90,.756,134,156,290,124,14,53,107,109,756
143,Hassan Whiteside\whiteha01,C,28,MIA,54,54,1364,312,578,.540,2,2,1.000,310,576,.538,.542,128,182,.703,174,444,618,54,37,94,92,131,754
144,Ersan İlyasova\ilyaser01,PF,30,TOT,69,43,1729,277,613,.452,91,253,.360,186,360,.517,.526,105,135,.778,118,287,405,90,61,26,72,157,750
145,Marvin Williams\willima02,PF,31,CHO,78,78,2006,258,563,.458,126,305,.413,132,258,.512,.570,102,123,.829,74,296,370,96,56,38,66,116,744
146,D'Angelo Russell\russeda01,PG,21,BRK,48,35,1234,278,672,.414,90,278,.324,188,394,.477,.481,97,131,.740,30,159,189,249,36,17,147,93,743
147,Nicolas Batum\batumni01,SG,29,CHO,64,64,1981,270,650,.415,92,274,.336,178,376,.473,.486,108,130,.831,57,249,306,349,65,23,131,72,740
148,Wilson Chandler\chandwi01,SF,30,DEN,74,71,2346,281,631,.445,88,246,.358,193,385,.501,.515,88,114,.772,102,296,398,159,43,39,92,156,738
149,Marcus Morris\morrima03,PF,28,BOS,54,21,1447,262,611,.429,86,234,.368,176,377,.467,.499,124,154,.805,43,246,289,72,35,12,65,100,734
150,Trey Lyles\lylestr01,PF,22,DEN,73,2,1391,270,550,.491,83,218,.381,187,332,.563,.566,101,143,.706,55,292,347,91,30,34,61,111,724
151,Mario Hezonja\hezonma01,SF,22,ORL,75,30,1657,273,617,.442,90,267,.337,183,350,.523,.515,86,105,.819,41,240,281,106,81,31,86,134,722
152,Troy Daniels\danietr01,SG,26,PHO,79,15,1622,232,575,.403,183,458,.400,49,117,.419,.563,56,64,.875,12,115,127,48,26,5,56,137,703
153,Anthony Tolliver\tollian01,PF,32,DET,79,14,1757,219,472,.464,159,365,.436,60,107,.561,.632,106,133,.797,50,191,241,90,32,21,58,144,703
154,Kris Dunn\dunnkr01,PG,23,CHI,52,43,1525,286,666,.429,43,134,.321,243,532,.457,.462,84,114,.737,24,197,221,310,104,27,150,174,699
155,C.J. Miles\milescj01,SF,30,TOR,70,3,1337,227,599,.379,164,454,.361,63,145,.434,.516,81,97,.835,18,134,152,55,37,21,39,134,699
156,Reggie Bullock\bullore01,SF,26,DET,62,52,1732,267,546,.489,125,281,.445,142,265,.536,.603,39,49,.796,27,127,154,95,47,13,47,70,698
157,Marcin Gortat\gortama01,C,33,WAS,82,82,2075,290,560,.518,0,0,,290,560,.518,.518,110,163,.675,181,442,623,151,40,61,99,175,690
158,Jerami Grant\grantje01,PF,23,OKC,81,1,1647,244,456,.535,32,110,.291,212,346,.613,.570,162,240,.675,86,233,319,57,31,77,54,155,682
159,Michael Kidd-Gilchrist\kiddgmi01,SF,24,CHO,74,74,1850,282,560,.504,0,2,.000,282,558,.505,.504,117,171,.684,84,218,302,71,51,32,53,143,681
160,Kyle Korver\korveky01,SG,36,CLE,73,4,1574,222,484,.459,164,376,.436,58,108,.537,.628,64,72,.889,9,156,165,88,31,27,55,130,672
161,Dwight Powell\poweldw01,C,26,DAL,79,25,1672,255,430,.593,28,84,.333,227,346,.656,.626,133,185,.719,135,309,444,91,67,32,59,186,671
162,Mike Scott\scottmi01,PF,29,WAS,76,1,1406,276,524,.527,66,163,.405,210,361,.582,.590,50,76,.658,50,197,247,80,23,10,79,148,668
163,George Hill\hillge01,PG,31,TOT,67,60,1812,236,513,.460,85,205,.415,151,308,.490,.543,110,140,.786,42,139,181,186,61,27,88,128,667
164,John Henson\hensojo01,C,27,MIL,76,69,1970,287,502,.572,1,7,.143,286,495,.578,.573,90,158,.570,150,363,513,114,45,109,84,202,665
165,J.R. Smith\smithjr01,SG,32,CLE,80,61,2244,240,595,.403,143,381,.375,97,214,.453,.524,39,56,.696,29,206,235,141,68,11,81,161,662
166,Avery Bradley\bradlav01,SG,27,TOT,46,46,1433,259,625,.414,75,203,.369,184,422,.436,.474,63,82,.768,22,94,116,94,51,8,101,92,656
167,Reggie Jackson\jacksre01,PG,27,DET,45,45,1201,246,577,.426,52,169,.308,194,408,.475,.471,112,134,.836,29,96,125,238,27,4,99,87,656
168,Fred VanVleet\vanvlfr01,PG,23,TOR,76,0,1520,232,545,.426,108,261,.414,124,284,.437,.525,84,101,.832,25,159,184,243,68,19,74,130,656
169,Rudy Gay\gayru01,PF,31,SAS,57,6,1231,253,537,.471,37,118,.314,216,419,.516,.506,112,145,.772,76,215,291,73,46,38,78,98,655
170,Dejounte Murray\murrade01,PG,21,SAS,81,48,1743,270,609,.443,9,34,.265,261,575,.454,.451,105,148,.709,110,349,459,231,97,31,134,151,654
171,Cory Joseph\josepco01,PG,26,IND,82,17,2210,256,604,.424,67,190,.353,189,414,.457,.479,70,94,.745,39,224,263,260,80,18,87,141,649
172,Evan Turner\turneev01,SF,29,POR,79,40,2034,258,577,.447,42,132,.318,216,445,.485,.484,91,107,.850,30,214,244,173,47,29,99,163,649
173,Al-Farouq Aminu\aminual01,PF,27,POR,69,67,2072,230,582,.395,125,339,.369,105,243,.432,.503,59,80,.738,97,428,525,84,79,40,79,136,644
174,Shabazz Napier\napiesh01,PG,26,POR,74,10,1535,223,531,.420,82,218,.376,141,313,.450,.497,116,138,.841,26,144,170,150,81,14,90,84,644
175,Darius Miller\milleda01,SF,27,NOP,82,3,1944,216,487,.444,147,358,.411,69,129,.535,.594,58,67,.866,18,146,164,111,28,17,58,160,637
176,Doug McDermott\mcderdo01,SF,26,TOT,81,4,1768,237,508,.467,92,216,.426,145,292,.497,.557,64,81,.790,40,160,200,79,19,16,56,122,630
177,Malcolm Brogdon\brogdma01,PG,25,MIL,48,20,1436,244,503,.485,62,161,.385,182,342,.532,.547,75,85,.882,23,133,156,152,41,13,66,128,625
178,Jerian Grant\grantje02,PG,25,CHI,74,26,1686,209,503,.416,61,187,.326,148,316,.468,.476,140,188,.745,31,141,172,342,63,8,89,132,619
179,Ryan Anderson\anderry01,PF,29,HOU,66,50,1725,207,480,.431,131,339,.386,76,141,.539,.568,72,93,.774,94,237,331,60,24,21,42,126,617
180,Dewayne Dedmon\dedmode01,C,28,ATL,62,46,1542,250,477,.524,50,141,.355,200,336,.595,.577,67,86,.779,100,389,489,90,40,51,86,162,617
181,Danny Green\greenda02,SG,30,SAS,70,60,1791,217,561,.387,116,320,.363,101,241,.419,.490,50,65,.769,41,208,249,110,63,80,74,122,600
182,Stanley Johnson\johnsst04,SF,21,DET,69,50,1894,210,560,.375,67,234,.286,143,326,.439,.435,112,145,.772,33,219,252,112,95,14,77,169,599
183,Devin Harris\harride01,PG,34,TOT,71,1,1340,187,454,.412,79,227,.348,108,227,.476,.499,142,170,.835,12,115,127,152,47,12,76,158,595
184,Pascal Siakam\siakapa01,PF,23,TOR,81,5,1679,253,498,.508,29,132,.220,224,366,.612,.537,54,87,.621,79,285,364,159,62,42,67,166,589
185,Jarrett Allen\allenja01,C,19,BRK,72,31,1441,234,397,.589,5,15,.333,229,382,.599,.596,114,147,.776,144,244,388,49,28,88,82,147,587
186,Alex Len\lenal01,C,24,PHO,69,13,1395,214,378,.566,1,3,.333,213,375,.568,.567,158,231,.684,175,343,518,82,27,61,78,158,587
187,Kyle Anderson\anderky01,SF,24,SAS,74,67,1978,231,438,.527,19,57,.333,212,381,.556,.549,104,146,.712,84,312,396,202,115,60,94,114,585
188,Nick Young\youngni01,SG,32,GSW,80,8,1393,201,488,.412,123,326,.377,78,162,.481,.538,56,65,.862,20,105,125,36,38,7,39,100,581
189,Manu Ginóbili\ginobma01,SG,40,SAS,65,0,1299,201,463,.434,64,192,.333,137,271,.506,.503,110,131,.840,19,123,142,163,43,16,105,126,576
190,Larry Nance\nancela02,C,25,TOT,66,27,1421,240,413,.581,2,12,.167,238,401,.594,.584,91,137,.664,161,291,452,82,88,38,51,172,573
191,JaMychal Green\greenja01,PF,27,MEM,55,54,1542,223,488,.457,43,127,.339,180,361,.499,.501,80,111,.721,147,317,464,79,32,25,76,153,569
192,Jakob Pöltl\poeltja01,C,22,TOR,82,0,1524,253,384,.659,1,2,.500,252,382,.660,.660,60,101,.594,165,228,393,57,39,100,85,212,567
193,Raymond Felton\feltora01,PG,33,OKC,82,2,1365,224,552,.406,81,230,.352,143,322,.444,.479,36,44,.818,25,131,156,203,49,16,76,91,565
194,Jarell Martin\martija01,PF,23,MEM,73,36,1661,221,496,.446,34,98,.347,187,398,.470,.480,89,116,.767,97,221,318,73,39,49,86,211,565
195,Luke Kennard\kennalu01,SG,21,DET,73,9,1463,206,465,.443,81,195,.415,125,270,.463,.530,65,76,.855,21,155,176,124,44,13,69,86,558
196,Marquese Chriss\chrisma01,PF,20,PHO,72,49,1527,202,477,.423,56,190,.295,146,287,.509,.482,96,158,.608,76,319,395,83,51,70,107,205,556
197,Bryn Forbes\forbebr01,SG,24,SAS,80,12,1517,209,497,.421,89,228,.390,120,269,.446,.510,48,72,.667,12,98,110,80,28,2,37,108,555
198,Paul Millsap\millspa01,PF,32,DEN,38,37,1143,202,435,.464,39,113,.345,163,322,.506,.509,112,161,.696,65,180,245,105,39,44,73,99,555
199,David Nwaba\nwabada01,SG,25,CHI,70,21,1646,202,423,.478,18,52,.346,184,371,.496,.499,133,203,.655,89,237,326,104,59,29,77,158,555
200,Delon Wright\wrighde01,PG,25,TOR,69,4,1433,201,432,.465,56,153,.366,145,279,.520,.530,97,117,.829,45,153,198,200,72,33,78,81,555
201,Tyler Ulis\ulisty01,PG,22,PHO,71,43,1658,214,551,.388,42,146,.288,172,405,.425,.426,84,101,.832,24,104,128,311,70,7,127,120,554
202,Emmanuel Mudiay\mudiaem01,PG,21,TOT,64,14,1245,204,526,.388,47,148,.318,157,378,.415,.433,98,129,.760,26,126,152,206,41,11,113,80,553
203,Ian Clark\clarkia01,SG,26,NOP,74,2,1455,222,495,.448,62,195,.318,160,300,.533,.511,45,59,.763,10,117,127,110,33,10,57,120,551
204,Kyle O'Quinn\oquinky01,C,27,NYK,77,10,1387,224,384,.583,4,17,.235,220,367,.599,.589,98,127,.772,121,349,470,158,36,98,100,192,550
205,Marcus Smart\smartma01,SG,23,BOS,54,11,1614,189,515,.367,75,249,.301,114,266,.429,.440,97,133,.729,43,146,189,259,71,23,129,133,550
206,Garrett Temple\templga01,SG,31,SAC,65,35,1615,199,476,.418,89,227,.392,110,249,.442,.512,60,78,.769,22,130,152,124,57,27,79,135,547
207,Rajon Rondo\rondora01,PG,31,NOP,65,63,1705,231,494,.468,50,150,.333,181,344,.526,.518,25,46,.543,31,232,263,533,70,10,151,119,537
208,Andrew Harrison\harrian01,PG,23,MEM,56,46,1326,181,429,.422,47,142,.331,134,287,.467,.477,124,159,.780,23,108,131,177,38,26,81,138,533
209,Dragan Bender\bendedr01,PF,20,PHO,82,37,2069,187,484,.386,118,322,.366,69,162,.426,.508,39,51,.765,40,321,361,130,22,53,112,166,531
210,Justise Winslow\winslju01,PF,21,MIA,68,25,1680,207,488,.424,49,129,.380,158,359,.440,.474,66,104,.635,64,306,370,148,54,33,77,140,529
211,Lonzo Ball\balllo01,PG,20,LAL,52,50,1780,203,564,.360,90,295,.305,113,269,.420,.440,32,71,.451,69,291,360,376,88,43,136,117,528
212,Greg Monroe\monrogr01,C,27,TOT,51,14,1040,218,386,.565,0,0,,218,386,.565,.565,88,119,.739,109,241,350,114,44,23,94,95,524
213,Mason Plumlee\plumlma01,C,27,DEN,74,26,1439,221,368,.601,0,1,.000,221,367,.602,.601,82,179,.458,132,268,400,142,49,81,103,184,524
214,Tomáš Satoranský\satorto01,SG,26,WAS,73,30,1643,201,384,.523,47,101,.465,154,283,.544,.585,75,96,.781,72,161,233,286,52,15,83,131,524
215,Skal Labissière\labissk01,PF,21,SAC,60,28,1240,205,458,.448,18,51,.353,187,407,.459,.467,95,118,.805,99,189,288,72,25,49,73,132,523
216,Tony Snell\snellto01,SG,26,MIL,75,59,2053,185,425,.435,108,268,.403,77,157,.490,.562,38,48,.792,9,132,141,98,47,28,36,115,516
217,James Ennis\ennisja01,SF,27,TOT,72,22,1604,182,384,.474,51,153,.333,131,231,.567,.540,97,116,.836,73,151,224,71,47,18,56,134,512
218,Mario Chalmers\chalmma01,PG,31,MEM,66,10,1421,168,443,.379,53,191,.277,115,252,.456,.439,118,138,.855,13,144,157,197,79,14,117,179,507
219,P.J. Tucker\tuckepj01,PF,32,HOU,82,34,2281,172,441,.390,115,310,.371,57,131,.435,.520,43,60,.717,93,364,457,77,78,26,74,205,502
220,Gerald Green\greenge01,SG,32,HOU,41,2,929,168,413,.407,110,298,.369,58,115,.504,.540,51,60,.850,15,118,133,25,24,15,31,87,497
221,Josh Hart\hartjo01,SG,22,LAL,63,23,1461,176,375,.469,78,197,.396,98,178,.551,.573,66,94,.702,42,221,263,80,47,16,47,107,496
222,David West\westda01,C,37,GSW,73,0,999,216,378,.571,3,8,.375,213,370,.576,.575,60,79,.759,64,174,238,138,47,75,80,120,495
223,Alec Burks\burksal01,SG,26,UTA,64,1,1059,170,414,.411,47,142,.331,123,272,.452,.467,107,124,.863,19,173,192,67,37,8,60,75,494
224,Jodie Meeks\meeksjo01,SG,30,WAS,77,0,1119,157,393,.399,72,210,.343,85,183,.464,.491,101,117,.863,15,111,126,70,29,4,37,55,487
225,Isaiah Thomas\thomais02,PG,28,TOT,32,15,862,157,421,.373,55,188,.293,102,233,.438,.438,117,131,.893,17,50,67,153,15,3,95,58,486
226,Aron Baynes\baynear01,C,31,BOS,81,67,1485,210,446,.471,3,21,.143,207,425,.487,.474,59,78,.756,130,304,434,93,22,51,80,200,482
227,T.J. McConnell\mccontj01,PG,25,PHI,76,1,1706,210,421,.499,27,62,.435,183,359,.510,.531,31,39,.795,37,189,226,303,92,13,112,122,478
228,Bam Adebayo\adebaba01,C,20,MIA,69,19,1368,174,340,.512,0,7,.000,174,333,.523,.512,129,179,.721,118,263,381,101,32,41,66,138,477
229,Kosta Koufos\koufoko01,C,28,SAC,71,13,1391,222,389,.571,0,0,,222,389,.571,.571,33,74,.446,149,323,472,87,47,32,49,146,477
230,Shelvin Mack\macksh01,PG,27,ORL,69,3,1365,178,414,.430,48,139,.345,130,275,.473,.488,69,97,.711,23,143,166,272,54,8,89,91,473
231,Gorgui Dieng\dienggo01,C,28,MIN,79,0,1333,186,388,.479,19,61,.311,167,327,.511,.504,79,102,.775,106,254,360,71,45,39,59,147,470
232,Bismack Biyombo\biyombi01,C,25,ORL,82,25,1495,183,352,.520,0,1,.000,183,351,.521,.520,102,157,.650,144,324,468,66,21,95,84,158,468
233,Jarrett Jack\jackja01,PG,34,NYK,62,56,1548,189,443,.427,25,86,.291,164,357,.459,.455,63,75,.840,22,169,191,348,35,4,115,98,466
234,Frank Ntilikina\ntilila01,PG,19,NYK,78,9,1706,182,500,.364,50,157,.318,132,343,.385,.414,49,68,.721,37,140,177,250,65,18,131,181,463
235,Trey Burke\burketr01,PG,25,NYK,36,9,785,193,384,.503,38,105,.362,155,279,.556,.552,37,57,.649,13,58,71,170,24,4,43,43,461
236,Luc Mbah a Moute\mbahalu01,PF,31,HOU,61,15,1564,166,345,.481,63,173,.364,103,172,.599,.572,65,95,.684,22,164,186,55,72,25,68,100,460
237,Dāvis Bertāns\bertada01,PF,25,SAS,77,10,1086,161,366,.440,94,252,.373,67,114,.588,.568,40,49,.816,18,135,153,74,26,28,36,93,456
238,Nemanja Bjelica\bjeline01,PF,29,MIN,67,21,1371,171,371,.461,76,183,.415,95,188,.505,.563,36,45,.800,53,221,274,86,50,16,52,141,454
239,Justin Jackson\jacksju01,SF,22,SAC,68,41,1506,185,419,.442,57,185,.308,128,234,.547,.510,26,36,.722,27,160,187,74,28,13,40,81,453
240,Isaiah Taylor\taylois01,PG,23,ATL,67,9,1167,163,390,.418,20,80,.250,143,310,.461,.444,99,141,.702,22,72,94,206,34,10,84,116,445
241,Pat Connaughton\connapa01,SG,25,POR,82,5,1488,165,390,.423,74,210,.352,91,180,.506,.518,37,44,.841,36,125,161,91,23,22,43,120,441
242,Tyler Zeller\zellety01,C,28,TOT,66,34,1109,187,334,.560,10,28,.357,177,306,.578,.575,57,79,.722,110,195,305,47,15,35,47,126,441
243,OG Anunoby\anunoog01,SF,20,TOR,74,62,1481,163,346,.471,73,197,.371,90,149,.604,.577,39,62,.629,44,140,184,55,52,14,45,130,438
244,Jonas Jerebko\jerebjo01,PF,30,UTA,74,19,1134,159,341,.466,65,157,.414,94,184,.511,.562,46,57,.807,53,193,246,42,24,12,27,127,429
245,Miloš Teodosić\teodomi01,PG,30,LAC,45,36,1134,151,360,.419,88,232,.379,63,128,.492,.542,39,46,.848,16,110,126,209,23,5,97,103,429
246,Dion Waiters\waitedi01,SG,26,MIA,30,30,918,163,410,.398,52,170,.306,111,240,.463,.461,51,69,.739,8,69,77,113,23,9,70,61,429
247,Trevor Booker\booketr01,PF,30,TOT,68,7,1158,177,343,.516,8,33,.242,169,310,.545,.528,66,93,.710,117,201,318,82,28,21,59,119,428
248,Ben McLemore\mclembe01,SG,24,MEM,56,17,1091,157,373,.421,55,159,.346,102,214,.477,.495,53,64,.828,34,105,139,51,38,15,61,139,422
249,Malik Monk\monkma01,SG,19,CHO,63,0,854,153,425,.360,83,243,.342,70,182,.385,.458,32,38,.842,8,58,66,91,20,9,49,60,421
250,Tony Parker\parketo01,PG,35,SAS,55,21,1071,178,388,.459,10,37,.270,168,351,.479,.472,55,78,.705,7,88,95,195,28,1,68,52,421
251,Dante Cunningham\cunnida01,SF,30,TOT,73,25,1562,164,364,.451,58,168,.345,106,196,.541,.530,31,52,.596,78,220,298,48,39,30,33,111,417
252,Tyus Jones\jonesty01,PG,21,MIN,82,11,1467,150,328,.457,45,129,.349,105,199,.528,.526,71,81,.877,16,116,132,232,95,6,59,110,416
253,Ed Davis\davised01,C,28,POR,78,0,1471,170,292,.582,0,1,.000,170,291,.584,.582,74,111,.667,183,392,575,40,32,52,66,188,414
254,Frank Mason\masonfr01,PG,23,SAC,52,2,984,144,380,.379,31,86,.360,113,294,.384,.420,94,115,.817,30,100,130,147,34,10,65,72,413
255,Quincy Acy\acyqu01,PF,27,BRK,70,8,1359,130,365,.356,102,292,.349,28,73,.384,.496,49,60,.817,40,217,257,57,33,29,60,149,411
256,Tyler Dorsey\dorsety01,SG,21,ATL,56,5,974,144,382,.377,72,199,.362,72,183,.393,.471,45,63,.714,17,113,130,79,17,5,37,63,405
257,Mike Muscala\muscami01,C,26,ATL,53,7,1060,143,312,.458,62,167,.371,81,145,.559,.558,57,62,.919,56,174,230,51,31,27,42,80,405
258,Wesley Johnson\johnswe01,SF,30,LAC,74,40,1486,150,368,.408,60,177,.339,90,191,.471,.489,43,58,.741,29,187,216,61,76,62,55,146,403
259,Marreese Speights\speigma01,C,30,ORL,52,3,675,138,349,.395,86,233,.369,52,116,.448,.519,40,55,.727,21,112,133,40,8,22,40,106,402
260,Zach LaVine\lavinza01,SG,22,CHI,24,24,656,136,355,.383,42,123,.341,94,232,.405,.442,87,107,.813,9,85,94,72,24,4,43,55,401
261,Shaun Livingston\livinsh01,PG,32,GSW,71,7,1129,172,343,.501,0,5,.000,172,338,.509,.501,50,61,.820,32,99,131,140,35,21,58,117,394
262,Jabari Parker\parkeja01,PF,22,MIL,31,3,743,160,332,.482,31,81,.383,129,251,.514,.529,40,54,.741,42,109,151,59,25,10,45,50,391
263,Maxi Kleber\klebima01,PF,26,DAL,72,36,1206,151,309,.489,40,128,.313,111,181,.613,.553,44,59,.746,71,163,234,51,26,47,30,114,386
264,Maurice Harkless\harklma01,SF,24,POR,59,36,1264,147,297,.495,49,118,.415,98,179,.547,.577,42,59,.712,46,116,162,53,48,43,40,103,385
265,Norman Powell\powelno01,SG,24,TOR,70,18,1062,150,374,.401,53,186,.285,97,188,.516,.472,32,39,.821,14,105,119,89,37,16,66,111,385
266,Andre Iguodala\iguodan01,SF,34,GSW,64,7,1622,148,320,.463,33,117,.282,115,203,.567,.514,55,87,.632,50,196,246,210,54,38,67,99,384
267,Corey Brewer\breweco01,SF-SG,31,TOT,72,18,1208,142,316,.449,31,110,.282,111,206,.539,.498,65,90,.722,43,111,154,65,79,14,49,139,380
268,Zaza Pachulia\pachuza01,C,33,GSW,69,57,972,149,264,.564,0,1,.000,149,263,.567,.564,75,93,.806,89,232,321,109,38,17,72,122,373
269,Joe Johnson\johnsjo02,SF,36,TOT,55,4,1205,146,360,.406,40,145,.276,106,215,.493,.461,40,45,.889,14,158,172,83,18,7,49,67,372
270,Ian Mahinmi\mahinia01,C,31,WAS,77,0,1145,138,248,.556,0,2,.000,138,246,.561,.556,90,128,.703,135,177,312,53,38,42,100,230,366
271,Deyonta Davis\davisde01,C,21,MEM,62,6,943,161,265,.608,0,0,,161,265,.608,.608,38,57,.667,75,175,250,40,15,39,32,125,360
272,Langston Galloway\gallola01,SG,26,DET,58,2,863,126,340,.371,75,218,.344,51,122,.418,.481,33,41,.805,13,79,92,58,35,5,18,39,360
273,Thon Maker\makerth01,C,20,MIL,74,12,1238,130,316,.411,31,104,.298,99,212,.467,.460,65,93,.699,75,150,225,46,38,53,44,162,356
274,Álex Abrines\abrinal01,SG,24,OKC,75,8,1134,115,291,.395,84,221,.380,31,70,.443,.540,39,46,.848,26,88,114,28,38,8,25,124,353
275,Royce O'Neale\onealro01,SF,24,UTA,69,4,1150,120,284,.423,42,118,.356,78,166,.470,.496,61,76,.803,25,211,236,95,36,16,55,105,343
276,Amir Johnson\johnsam01,C,30,PHI,74,18,1171,140,260,.538,10,32,.313,130,228,.570,.558,52,85,.612,123,207,330,118,45,44,55,192,342
277,Nenê Hilário\hilarne01,C,35,HOU,52,4,758,136,239,.569,0,2,.000,136,237,.574,.569,68,107,.636,54,122,176,45,28,14,38,123,340
278,Malcolm Delaney\delanma01,PG,28,ATL,54,3,1014,109,285,.382,46,124,.371,63,161,.391,.463,74,92,.804,9,91,100,163,35,6,66,82,338
279,Mike James\jamesmi02,PG,27,TOT,36,10,687,123,321,.383,26,98,.265,97,223,.435,.424,64,84,.762,13,77,90,126,28,7,49,48,336
280,Daniel Theis\theisda01,C,25,BOS,63,3,936,126,233,.541,18,58,.310,108,175,.617,.579,61,81,.753,90,184,274,56,30,48,56,157,331
281,Sean Kilpatrick\kilpase01,SG,28,TOT,52,1,640,110,294,.374,46,144,.319,64,150,.427,.452,64,72,.889,5,82,87,46,13,5,38,33,330
282,Wayne Selden\seldewa01,SG,23,MEM,35,9,692,116,269,.431,49,122,.402,67,147,.456,.522,44,59,.746,16,40,56,66,18,5,54,59,325
283,Danilo Gallinari\gallida01,SF,29,LAC,21,21,671,102,256,.398,36,111,.324,66,145,.455,.469,81,87,.931,9,92,101,41,12,10,26,30,321
284,Patrick Patterson\pattepa01,PF,28,OKC,82,3,1270,106,266,.398,66,171,.386,40,95,.421,.523,40,46,.870,32,161,193,57,48,23,33,87,318
285,Vince Carter\cartevi01,SF,41,SAC,58,5,1026,114,283,.403,57,165,.345,57,118,.483,.504,28,37,.757,18,130,148,69,42,26,36,96,313
286,Quinn Cook\cookqu01,PG,24,GSW,33,18,740,122,252,.484,46,104,.442,76,148,.514,.575,22,25,.880,10,72,82,89,12,1,32,59,312
287,Thabo Sefolosha\sefolth01,SF,33,UTA,38,6,806,118,240,.492,32,84,.381,86,156,.551,.558,44,54,.815,29,132,161,33,52,12,30,59,312
288,Richaun Holmes\holmeri01,C,24,PHI,48,2,746,135,241,.560,4,31,.129,131,210,.624,.568,37,56,.661,57,154,211,61,20,29,25,97,311
289,JaVale McGee\mcgeeja01,C,30,GSW,65,17,615,136,219,.621,0,6,.000,136,213,.638,.621,38,52,.731,59,110,169,33,21,57,27,91,310
290,Cristiano Felício\feliccr01,C,25,CHI,55,16,977,127,215,.591,0,2,.000,127,213,.596,.591,54,81,.667,83,150,233,55,16,11,54,104,308
291,Jerryd Bayless\bayleje01,SG,29,PHI,39,11,925,109,262,.416,54,146,.370,55,116,.474,.519,35,44,.795,15,65,80,54,23,6,46,91,307
292,Tristan Thompson\thomptr01,C,26,CLE,53,22,1072,132,235,.562,0,0,,132,235,.562,.562,43,79,.544,126,226,352,33,16,17,36,102,307
293,Sam Dekker\dekkesa01,PF,23,LAC,73,1,883,128,259,.494,10,60,.167,118,199,.593,.514,37,56,.661,44,130,174,38,24,9,33,71,303
294,Omri Casspi\casspom01,SF,29,GSW,53,7,740,120,207,.580,10,22,.455,110,185,.595,.604,50,69,.725,30,170,200,51,18,19,37,71,300
295,Tyson Chandler\chandty01,C,35,PHO,46,46,1151,121,187,.647,0,0,,121,187,.647,.647,58,93,.624,134,284,418,53,16,27,59,106,300
296,Timothé Luwawu-Cabarrot\luwawti01,SF,22,PHI,52,7,807,100,267,.375,53,158,.335,47,109,.431,.474,46,58,.793,14,58,72,54,12,5,38,97,299
297,Lance Thomas\thomala01,PF,29,NYK,73,31,1353,102,267,.382,50,124,.403,52,143,.364,.476,44,53,.830,44,131,175,44,30,14,40,134,298
298,Zach Collins\colliza01,C,20,POR,66,1,1045,115,289,.398,35,113,.310,80,176,.455,.458,27,42,.643,45,176,221,52,17,31,58,133,292
299,Tyrone Wallace\wallaty01,PG,23,LAC,30,19,851,110,247,.445,10,40,.250,100,207,.483,.466,61,78,.782,21,84,105,71,27,13,46,83,291
300,Chandler Parsons\parsoch01,SF,29,MEM,36,8,691,108,234,.462,51,121,.421,57,113,.504,.571,17,27,.630,14,76,90,69,18,11,35,53,284
301,Sindarius Thornwell\thornsi01,SG,23,LAC,73,17,1156,100,233,.429,23,61,.377,77,172,.448,.479,59,88,.670,33,107,140,68,48,25,53,125,282
302,Treveon Graham\grahatr01,SG,24,CHO,63,2,1050,96,221,.434,40,97,.412,56,124,.452,.525,41,59,.695,42,79,121,59,33,2,27,109,273
303,Kevon Looney\looneke01,C,21,GSW,66,4,910,112,193,.580,1,5,.200,111,188,.590,.583,42,77,.545,83,132,215,42,34,56,31,106,267
304,Channing Frye\fryech01,C,34,TOT,53,1,695,104,212,.491,39,115,.339,65,97,.670,.583,17,19,.895,12,123,135,38,18,13,21,69,264
305,Noah Vonleh\vonleno01,PF,22,TOT,54,16,875,104,234,.444,20,66,.303,84,168,.500,.487,36,58,.621,70,241,311,34,19,17,31,68,264
306,Jordan Bell\belljo01,C,23,GSW,57,13,809,116,185,.627,0,4,.000,116,181,.641,.627,30,44,.682,60,147,207,102,35,56,51,92,262
307,Luke Babbitt\babbilu01,SF,28,TOT,50,14,715,91,215,.423,60,156,.385,31,59,.525,.563,17,22,.773,7,89,96,31,8,7,19,54,259
308,José Calderón\caldejo01,PG,36,CLE,57,32,914,93,185,.503,45,97,.464,48,88,.545,.624,24,30,.800,14,70,84,117,27,2,41,81,255
309,Cheick Diallo\diallch01,PF,21,NOP,52,0,581,102,176,.580,0,0,,102,176,.580,.580,50,66,.758,47,164,211,19,11,21,28,82,254
310,Al Jefferson\jeffeal01,C,33,IND,36,1,484,111,208,.534,0,3,.000,111,205,.541,.534,30,36,.833,30,113,143,30,16,23,21,66,252
311,Jameer Nelson\nelsoja01,PG,35,TOT,50,0,1013,95,244,.389,41,124,.331,54,120,.450,.473,16,20,.800,13,91,104,179,27,4,67,81,247
312,Willy Hernangómez\hernawi01,C,23,TOT,48,1,495,91,164,.555,5,12,.417,86,152,.566,.570,59,90,.656,61,122,183,33,18,16,35,64,246
313,Michael Carter-Williams\cartemi01,PG,26,CHO,52,2,835,76,229,.332,14,59,.237,62,170,.365,.362,73,89,.820,37,101,138,116,44,23,52,99,239
314,Cedi Osman\osmande01,SF,22,CLE,61,12,672,90,186,.484,32,87,.368,58,99,.586,.570,26,46,.565,19,101,120,41,22,3,32,78,238
315,Miles Plumlee\plumlmi01,C,29,ATL,55,35,918,105,180,.583,0,0,,105,180,.583,.583,27,60,.450,77,151,228,45,17,30,63,79,237
316,Justin Anderson\anderju01,SF,24,PHI,38,0,519,87,202,.431,34,103,.330,53,99,.535,.515,28,38,.737,25,68,93,25,15,7,16,54,236
317,Boban Marjanović\marjabo01,C,29,TOT,39,1,337,79,148,.534,0,0,,79,148,.534,.534,77,97,.794,48,96,144,22,10,11,36,51,235
